1111111111111
10010000000C111
100001111100111
1P0011E0000011
111111111111
