111111r111111
1001p000000C1
100001t111001
1P0011E000001
1111111111111
